###################
1----P---#--------2
#-##-###-#-###-##-#
#-##-###-#-###-##-#
#-----------------#
#-##-#-#####-#-##-#
#----#---#---#----#
####-###-1-###-####
   #-#-------#-#   
####-#-##-##-#-####
0------#-A-#--E---0
####-#-#####-#-####
   #-#-------#-#   
####-#-#####-#-####
#--------#--------#
#-##-###-#-###-##-#
#--#-----------#--#
##-#-#-#####-#-#-##
#--*-#---#---#-*--#
#-######-#-######-#
2-B-------------C-#
###################
