###################
1----P---#--------2
#-##-###-#-###-##-#
#-##-###-#-###-##-#
#-----------------#
#-##-#-#####-#E##-#
#----#---#---#----#
####-###-1-###-####
   #-#-------#-#   
####-#-##-##-#-####
0------#-A-#------0
####-#-#####-#-####
   #-#-------#-#   
####-#-#####-#-####
#--------#--------#
#-##-###-#-###-##-#
#--#-----B-----#--#
##-#-#-#####-#-#-##
#--*-#---#---#-*--#
#-######-#-######-#
2-C-------------F-#
###################
