###################
#A-------#-----E--2
#-##-###-#-###-##-#
#-##-###-#-###-##-#
#----P------------#
#-##-#-#####-#-##-#
#----#---#---#----#
####-###---###-####
   #-#-------#-#   
####-#-##-##-#-####
0------#-C-#------0
####-#-#####-#-####
   #-#-------#-#   
####-#-#####-#-####
#--------#--------#
#-##-###-#-###*##-#
#--#-----------#--#
##-#-#-#####-#-#-##
#-*--#---#---#----#
#-######-#-######-#
2---------------B-#
###################
