###################
1----P---#-----E--2
#-##-###-#-###-##-#
#-##-###-#-###-##-#
#-----------A-----#
#-##-#-#####C#-##-#
#*---#---#---#----#
####-###-1-###-####
   #-#-------#-#   
####-#-##-##-#-####
0------#---#------0
####-#-#####-#-####
   #-#-------#-#   
####-#-#####-#-####
#--------#--------#
#-##-###-#-###-##-#
#--#-----------#--#
##-#-#-#####-#-#-##
#----#---#---#-*--#
#-######-#-######-#
2---------------B-#
###################
