###########################################################################################################################################################################################################################################
#P                                                                                                                                                                                                                                        #
#                                                                                                                                                                                                                                         #
#                                                                                                                                                                                                                                         #
#                                                                                                                                                                                                                                         #
#                                                                                                                                                                                                                                         #
#                                                                                                                                                                                                                                         #
#                                                                                                                                                                                                                                         #
#                                                                                                                                                                                                                                         #
#                                                                                                                                                                                                                                         #
#                                                                                                                                                                                                                                         #
#                                                                                                                                                                                                                                         #
#                                                                                                                                                                                                                                         #
#                                                                                                                                                                                                                                         #
#                                                                                                                                                                                                                                         #
#                                                                                                                                                                                                                                         #
#                                                                                                                                                                                                                                         #
#                                                                                                                                                                                                                                         #
#                                                                                                                                                                                                                                         #
#                                                                                                                                                                                                                                         #
#                                                                                                                                                                                                                                         #
#                                                                                                                                                                                                                                         #
#                                                                                                                                                                                                                                         #
#                                                                                                                                                                                                                                         #
#                                                                                                                                                                                                                                         #
#                                                                                                                                                                                                                                         #
#                                                                                                                                                                                                                                         #
#                                                                                                                                                                                                                                         #
#                                                                                                                                                                                                                                         #
#                                                                                                                                                                                                                                         #
#                                                                                                                                                                                                                                         #
#                                                                                                                                                                                                                                         #
#                                                                                                                                                                                                                                         #
#                                                                                                                                                                                                                                         #
#                                                                                                                                                                                                                                         #
#                                                                                                                                                                                                                                         #
#                                                                                                                                                                                                                                         #
#                                                                                                                                                                                                                                         #
#                                                                                                                                                                                                                                         #
#                                                                                                                                                                                                                                         #
#                                                                                                                                                                                                                                         #
#                                                                                                                                                                                                                                         #
#                                                                                                                                                                                                                                         #
#                                                                                                                                                                                                                                         #
#                                                                                                                                                                                                                                         #
#                                                                                                                                                                                                                                         #
#                                                                                                                                                                                                                                         #
#                                                                                                                                                                                                                                         #
#                                                                                                                                                                                                                                         #
#                                                                                                                                                                                                                                         #
#                                                                                                                                                                                                                                         #
#                                                                                                                                                                                                                                         #
#                                                                                                                                                                                                                                         #
#                                                                                                                                                                                                                                        A#
###########################################################################################################################################################################################################################################
