###################
1----P---#--------2
#-##-###-#-###-##-#
#-##-###-#-###-##-#
#-----------------#
#-##-#-#####-#E##-#
#----#---#---#----#
####-###-1-###-####
   #-#-------#-#   
####-#-##I##-#-####
0------#-*-#------0
####-#-#####-#-####
   #-#-------#-#   
####-#-#####-#-####
#---A----#--------#
#-##-###-#-###-##-#
#--#----------F#--#
##-#-#-#####-#-#-##
#--*-#---#---#----#
#-######-#-######-#
2-CH-----------B--#
###################
