###################
#--------#-----E--2
#-##-###-#-###-##-#
#-##*###-#-###-##-#
#-----------------#
#-##-#-#####C#-##-#
#----#---#---#----#
####-###-1-###-####
   #-#-----A-#-#   
####-#-##-##-#-####
0------#---#------0
####-#-#####-#-####
   #-#-------#-#   
####-#-#####P#-####
#--------#--1-----#
#-##-###-#-###-##-#
#--#-----------#--#
##-#-#-#####-#-#-##
#----#---#---#----#
#-######*#-######-#
2---------------B-#
###################
